111111111111111111111111111111111111111111111111111111111111111111111
100000000000000000000000000000000000000000000000000000000000000000001
100000000000000000000000000000000000000000000000000000000000000000001
100000000000000000000000000000000000000000000000000000000000000000001
10000000000000000000000000000000000000000000B000000000000000000000001
100000000000000000000000000000000000000000000000000000000000000000001
1000000000000000000000000P0000000000000000000000000000000000000000001
100000000000000000000000000000000000000000000000000000000000000000001
100000000000000000000100000000011111111111111000000000000000000000001
100000000000000000001100000000010000000000001000000000000000000000001
100000000000000000010100000000010000000000001000000000000000000000001
100000000000000000010100000000010000000000001000000000000000000000001
100000000000000000100100000000010000000000001000000000000000000000001
100000000000000001000100000000010000000000001000000000000000000000001
100000000000000001000100000000010000000000001000000000000000000000001
100000000000000010000100000000011111111111111000000000000000000000001
100000000000000000000100000000000000000000001000000000000000000000001
100000000000000000000100000000000000000000001000000000000000000000001
100000000000000000000100000000000000000000001000000000000000000000001
100000000000000000000100000000000000000000001000000000000000000000001
100000000000000000000100000000000000000000001000000000000000000000001
100000000000000000000100000000000000000000001000000000000000000000001
100000000000000000000100000000000000000000001000000000000000000000001
100000000000000000000100000000000000000000001000000000000000000000001
100000000000000000000100000000000000000000001000000000000000000000001
100000000000000000000100000000000000000000001000000000000000000000001
100000000000000000000100000000000000000000001000000000000000000000001
100000000000000000000100000000000000000000001000000000000000000000001
100000000000000000000100000000011111111111111000000000000000000000001
100000000000000000000000000000000000000000000000000000000000000000001
100000000000000000000000000000000000000000000000000000000000000000001
100000000000000000000000000000000000000000000000000000000000000000001
100000000000000000000000000000000000000000000000000000000000000000001
10000000C000000000000000000000000000000000000000000000000000000000001
100000000000000000000000000000000000000000000000000000000000000000001
100000000000000000000000000000000000000000000000000000000000000000001
100000000000000000000000000000000000000000000000000000000000000000001
100000000000000000000000000000000000000000000000000000000000000000001
100000000000000000000000000000000000000000000000000000000000000000001
100000000000000000000000000000000000000000000000000000000000000000001
100000000000000000000000000000000000000000000000000000000000000000001
100000000000000000000000000000000000000000000000000000000000000000001
100000000000000000000000000000000000000000000000000000000000000000001
10000000000000000000000000000000000000000000000000E000000000000000001
100000000000000000000000000000000000000000000000000000000000000000001
100000000000000000000000000000000000000000000000000000000000000000001
100000000000000000000000000000000000000000000000000000000000000000001
100000000000000000000000000000000000000000000000000000000000000000001
100000000000000000000000000000000000000000000000000000000000000000001
100000000000000000000000000000000000000000000000000000000000000000001
100000000000000000C00000000000000000000000000000000000000000000000001
100000000000000000000000000000000000000000000000000000000000000000001
100000000000000000000000000000000000000000000000000000000000000000001
100000000000000000000000000000000000000000000000000000000000000000001
100000000000000000000000000000000000000000000000000000000000000000001
100000000000000000000000000000000000000000000000000000000000000000001
100000000000000000000000000000000000000000000000000000000000000000001
100000000000000000000000000000000000000000000000000000000000000000001
111111111111111111111111111111111111111111111111111111111111111111111
