111111111111111111111111111111111111111111111111111111111111111111111
100000000P01C0000001000100000000000000000000100000000000B0000000C0001
10000011111100010001000100100000E000000000001000000000000000000000001
100000000000000100000100001000000000000000000000000000B000000000C0001
111111111111111111111111111111111111111111111111111111111111111111111
