11111111111111111
110010000000C0001
11000011111000001
1100P11000000C001
11000110000000001
11000110000000001
11000110000000001
11000110000000001
11000110000000001
11000110000000001
11000110000000001
11000110000000001
11111111111111111