111111111111111111111111111111111111111111111111111111111111111111111
100000000P01C0000001000100000000000000000000100000000000C0000000C0001
1E0000111111000100010001001000000000000000001000000000000000000000001
100000000000000100000100001000000000000000000000000000000000000000001
100000000000000000000100001000000000000000000000000000000000000000001
10000000000000000000010000100000C000000000000C00000000000000000000001
100000000000000100000000001000000000000000000000000000000000000000001
1000000C0000000100000000001000000000000C00000000000000000000000000001
100000000000000000000000000000000000000000000000000000000000000000001
111111111111111111111111111111111111111111111111111111111111111111111
