111111111111111111111111111111111111111111111111111111111111111111111
100000000P01C0000001000100000000000000000000100000000000E0000000C0001
100000111111000100010001001000000000000000001000000000000000000000001
1000000000000001000001000010000000000000000000000000000000000000C0001
111111111111111111111111111111111111111111111111111111111111111111111
