11111111111111111111111111111111111111111111111111111111111111
1CCCCCCCCCCCCCCCCCCCCCCC111111111111111101110010101000000000C1
1CCCCCCCCCCCCCCCCCCCCCCC11111111111111110111001010100000000001
1CCCCCCCCCCCCCCCCCCCCCEC11111111111111110111001010100000000001
1CCCCCCCCCCCCCCCCCCCCCCC11111111111111110111001010100000000001
1CCCCCCCCCCCCCCCCCCCCCCC11111111111111110111001010100000000001
1CCCCCCCCCCCCCCCCCCCCCCC11111111111111110111001010100000000001
1CCCCCCCCCCCCCCCCCCCCCCC11111111111111110111001010100000000001
1CCCCCCCCCCCCCCCCCCCCCCC11111111111111110111001010100000000001
1CCCCCCCCCCCCCCCCCCCCCCC11111111111111110111001010100000000001
1CCCCCCCCCCCCCCCCCCCCCCC11111111111111110111001010100000000001
1CCCCCCCCCCCCCCCCCCCCCCC11111111111111110111001010100000000001
1CCCCCCCCCCCCCCCCCCCCCCC11111111111111110111001010100000000001
1CCCCCCCCCCCCCCCCCCCCCCC11111111111111110111001010100000000001
10000000000000000000000011111111111111110111001010100000000001
10000000000000000000000011111111111111110111001010100000000001
10000000000000000000000011111111111111110111001010100000000001
10000000000000000000000011111111111111110111001010100000000001
10000000000000000000000011111111111111110111001010100000000001
10000000000000000000000011111111111111110111001010100000000001
10000000000000000000000011111111111111110111001010100000000001
10000000000000000000000011111111111111110111001010100000000001
10000000000000000000000011111111111111110111001010100000000001
10000000000000000000000011111111111111110111001010100000000001
10000000000000000000000011111111111111110111001010100000000001
10000000000000000000000011111111111111110111001010100000000001
10000000000000000000000011111111111111110111001010100000000001
10000000000000000000000011111111111111110111001010100000000001
10000000000000000000000011111111111111110111001010100000000001
10000000000000000000000011111111111111110111001010100000000001
10000000000000000000000011111111111111110111001010100000000001
10000000000000000000000011111111111111110111001010100000000001
10000000000000000000000011111111111111110111001010100000000001
10000000000000000000000011111111111111110111001010100000000001
10000000000000000000000011111111111111110111001010100000000001
10000000000000000000000011111111111111110111001010100000000001
100000000000000P0000000011111111111111110111001010100000000001
10000000000000000000000011111111111111110111001010100000000001
10000000000000000000000011111111111111110111001010100000000001
10000000000000000000000011111111111111110111001010100000000001
10000000000000000000000011111111111111110111001010100000000001
11111111111111111111111111111111111111111111111111111111111111
